LEVEL_INFORMATION
No pain, no gain - jailbreak
TILES
2,2,2,2,2,2,2,2,2,2,2,2,2,2,2,2,2,2,2,2,2,2,2,2,2,2,2,2,2,2,2,2,2,2,2,2,2,2,
2,1,1,1,1,1,1,1,1,2,1,1,1,1,1,2,1,1,1,1,2,1,1,1,1,1,1,1,1,2,1,1,1,1,1,1,1,2,
2,1,1,1,1,1,1,1,1,2,1,1,1,1,1,2,1,1,1,1,1,1,1,1,1,1,1,1,1,2,1,1,1,1,1,1,1,2,
2,1,1,2,1,1,1,1,1,2,1,1,1,1,1,2,1,1,1,1,1,1,1,1,1,1,2,1,1,2,1,1,1,1,2,1,1,2,
2,1,1,2,1,1,1,1,1,2,1,1,1,1,1,2,1,1,1,1,2,1,1,1,1,1,2,2,2,2,1,1,1,1,2,1,1,2,
2,2,2,2,2,2,2,2,2,2,1,1,1,1,1,2,2,2,2,2,2,1,1,1,1,1,2,1,1,1,1,1,1,1,2,1,1,2,
2,1,1,2,1,1,1,1,1,2,1,1,1,1,1,2,1,1,1,1,2,1,1,1,1,1,2,1,1,1,1,1,1,1,2,1,1,2,
2,1,1,1,1,1,1,1,1,2,1,1,1,1,1,2,1,1,1,1,1,1,1,1,1,1,2,1,1,2,2,2,2,2,2,1,1,2,
2,1,1,1,1,1,1,1,1,2,1,1,1,1,1,2,1,1,1,1,1,1,1,1,1,1,1,1,1,2,1,1,1,1,1,1,1,2,
2,1,1,2,1,1,1,1,1,2,1,1,1,1,1,2,1,1,1,1,2,1,1,1,1,1,1,1,1,2,1,1,1,1,1,1,1,2,
2,2,2,2,2,2,2,2,2,2,1,1,1,1,1,2,2,2,2,2,2,1,1,1,1,1,2,2,2,2,1,1,1,1,2,2,2,2,
2,1,1,2,1,1,1,1,1,2,1,1,1,1,1,2,1,1,1,1,2,1,1,1,1,1,1,1,1,2,1,1,1,1,1,1,1,2,
2,1,1,1,1,1,1,1,1,2,1,1,1,1,1,2,1,1,1,1,1,1,1,1,1,1,1,1,1,2,1,1,1,1,1,1,1,2,
2,1,1,1,1,1,1,1,1,2,1,1,1,1,1,2,1,1,1,1,1,1,1,1,1,1,2,1,1,2,2,2,2,2,2,1,1,2,
2,1,1,2,1,1,1,1,1,2,1,1,1,1,1,2,1,1,1,1,2,1,1,1,1,1,2,1,1,1,1,1,1,1,2,1,1,2,
2,2,2,2,2,2,2,2,2,2,1,1,1,1,1,2,2,2,2,2,2,1,1,1,1,1,2,1,1,1,1,1,1,1,2,1,1,2,
2,1,1,2,1,1,1,1,1,2,1,1,1,1,1,2,1,1,1,1,2,1,1,1,1,1,2,2,2,2,1,1,1,1,2,1,1,2,
2,1,1,2,1,1,1,1,1,2,1,1,1,1,1,2,1,1,1,1,1,1,1,1,1,1,2,1,1,2,1,1,1,1,2,1,1,2,
2,1,1,1,1,1,1,1,1,2,1,1,1,1,1,2,1,1,1,1,1,1,1,1,1,1,1,1,1,2,1,1,1,1,1,1,1,2,
2,1,1,1,1,1,1,1,1,2,1,1,1,1,1,2,1,1,1,1,2,1,1,1,1,1,1,1,1,2,1,1,1,1,1,1,1,2,
2,2,2,2,2,2,2,2,2,2,2,2,2,2,2,2,2,2,2,2,2,2,2,2,2,2,2,2,2,2,2,2,2,2,2,2,2,2
POSITION
SHIELDMAIDEN 100 150 1
SHIELDMAIDEN 100 400 2
SHIELDMAIDEN 100 650 3
SHIELDMAIDEN 100 900 4
BUNNY 300 350
BUNNY 300 600
BUNNY 900 150
BUNNY 900 400
BUNNY 900 650
BUNNY 900 900
BUNNY 1650 50
BUNNY 1650 100
BUNNY 1650 900
BUNNY 1650 950
PENGUIN 1800 400
PENGUIN 1800 600
VDOOR 450 50 1
VDOOR 150 300 2
VDOOR 450 300 2
VDOOR 150 550 3
VDOOR 450 550 3
VDOOR 450 800 4
VDOOR 750 50 5
VDOOR 750 300 6
VDOOR 750 550 7
VDOOR 750 800 8
VDOOR 1300 0 9
VDOOR 1300 350 10
VDOOR 1300 500 11
VDOOR 1300 850 12
VDOOR 1450 200 13
VDOOR 1450 650 14
VDOOR 1700 350 15
VDOOR 1700 500 15
TRAPDOOR 1505 350 17
HANDLE 360 170 2
HANDLE 360 760 3
HANDLE 860 300 5
HANDLE 860 550 8
HANDLE 1760 250 15
HANDLE 1510 500 99
HANDLE 1360 100 10
HANDLE 1360 800 11
LOCK 463 134 ORANGE 4
LOCK 463 884 GREEN 3
LOCK 737 384 RED 1
LOCK 737 634 BLUE 2
LOCK 1287 84 ORANGE 4
LOCK 1287 934 GREEN 3
LOCK 1437 284 ALL 5
LOCK 1437 734 ALL 5
KEY 100 300 ORANGE 4
KEY 100 550 GREEN 3
KEY 300 200 RED 1
KEY 300 800 BLUE 2
KEY 950 50 ORANGE 4
KEY 950 800 GREEN 3
KEY 1400 50 ALL 5
KEY 1400 950 ALL 5
ENDOFFILE

note: this is not the actual tutorial level, more like a test level