LEVEL_INFORMATION
Test_Level - Made by Jeff
TILES
2,2,2,2,2,2,2,2,2,2,2,2,2,2,2,2,2,2,2,2,2,2,2,2,2,2,2,2,2,2,2,2,2,2,2,2,2,2,
2,1,1,1,1,1,1,1,1,1,1,1,5,6,6,6,5,7,8,8,7,5,6,6,6,5,1,1,1,1,1,1,1,1,1,1,1,2,
2,1,1,1,1,1,1,1,1,1,1,1,5,6,6,6,5,7,8,8,7,5,6,6,6,5,1,1,1,1,1,1,1,1,1,1,1,2,
2,1,1,1,5,4,1,1,1,2,1,1,5,6,6,5,5,7,8,8,7,5,5,6,6,5,1,1,2,1,1,1,4,5,1,1,1,2,
2,1,1,1,4,5,1,1,5,5,2,5,5,6,6,6,6,7,8,8,7,6,6,6,6,5,5,2,5,5,1,1,5,4,1,1,1,2,
2,1,1,1,1,1,1,1,4,3,3,3,6,6,6,6,6,7,8,8,7,6,6,6,6,6,3,3,3,4,1,1,1,1,1,1,1,2,
2,1,1,1,1,1,1,1,5,3,3,5,2,2,2,2,2,2,2,2,2,2,2,2,2,2,5,3,3,5,1,1,1,1,1,1,1,2,
2,3,3,3,3,2,1,1,5,3,3,4,3,3,3,7,6,6,4,5,6,6,7,3,3,3,4,3,3,5,1,1,2,3,3,3,3,2,
2,3,3,3,3,2,6,6,5,3,3,5,3,3,5,7,6,6,5,5,6,6,7,5,3,3,5,3,3,5,6,6,2,3,3,3,3,2,
2,1,1,3,3,2,5,4,5,3,3,5,3,3,5,7,6,6,4,5,6,6,7,5,3,3,5,3,3,4,5,5,2,3,3,1,1,2,
2,3,3,3,3,3,3,3,3,3,3,2,6,6,5,7,6,6,5,4,6,6,7,5,6,6,2,3,3,3,3,3,3,3,3,3,3,2,
2,1,1,3,3,2,5,5,5,5,2,5,5,5,5,7,6,6,5,5,6,6,7,5,5,5,5,2,5,5,5,4,2,3,3,1,1,2,
2,3,3,3,3,2,1,1,6,6,6,6,6,6,4,3,3,3,4,3,3,3,3,4,6,6,6,6,6,6,1,1,2,3,3,3,3,2,
2,3,3,3,3,2,1,1,6,6,6,6,6,6,4,3,3,3,3,3,3,3,3,3,6,6,6,6,6,6,1,1,2,3,3,3,3,2,
2,1,1,1,1,1,1,1,5,6,6,6,6,6,4,3,3,3,4,4,4,3,3,4,6,6,6,6,6,5,1,1,1,1,1,1,1,2,
2,1,1,1,1,1,1,1,5,6,6,6,6,6,3,3,3,3,3,3,3,3,3,4,6,6,6,6,6,5,1,1,1,1,1,1,1,2,
2,1,1,1,4,5,5,4,2,5,5,5,5,5,4,4,3,3,3,3,4,3,3,4,5,5,5,5,5,2,4,5,5,4,1,1,1,2,
2,1,1,1,5,4,3,3,6,6,6,6,6,6,3,4,3,3,3,3,3,3,3,4,6,6,6,6,6,6,3,3,4,5,1,1,1,2,
2,1,1,1,1,1,3,3,6,6,6,6,6,6,3,3,3,3,3,4,3,3,3,4,6,6,6,6,6,6,3,3,1,1,1,1,1,2,
2,1,1,1,1,1,3,3,2,6,6,6,6,6,3,3,4,4,3,4,3,3,3,3,6,6,6,6,6,2,3,3,1,1,1,1,1,2,
2,2,2,2,2,2,2,2,2,2,2,2,2,2,2,2,2,2,2,2,2,2,2,2,2,2,2,2,2,2,2,2,2,2,2,2,2,2
POSITION
SHIELDMAIDEN 1800 100 1
SHIELDMAIDEN 100 100 2
SHIELDMAIDEN 100 950 3
SHIELDMAIDEN 1800 950 4
BUNNY 350 950
BUNNY 400 250
BUNNY 400 300
BUNNY 550 170
BUNNY 600 650
BUNNY 650 950
BUNNY 730 80
BUNNY 760 120
BUNNY 790 90
BUNNY 780 400
BUNNY 810 450
BUNNY 860 430
BUNNY 950 180
BUNNY 1020 400
BUNNY 1050 440
BUNNY 1090 420
BUNNY 1120 80
BUNNY 1140 90
BUNNY 1130 100
BUNNY 1280 670
BUNNY 1280 960
BUNNY 1340 170
BUNNY 1480 240
BUNNY 1500 280
BUNNY 1540 950
ENDOFFILE

note: this is not the actual tutorial level, more like a test level