LEVEL_INFORMATION
Level with a touch of beign a zoo (no animals were harmed during the making of the level)
TILES
2,2,2,2,2,2,2,2,2,2,2,2,2,2,2,2,2,2,2,2,2,2,2,2,2,2,2,2,2,2,2,2,2,2,2,2,2,2,
2,1,1,1,1,1,1,1,1,1,1,1,1,1,1,1,1,1,1,6,6,7,5,5,5,5,5,8,8,8,8,5,5,8,8,8,8,2,
2,1,1,1,1,1,1,1,1,1,1,1,1,1,1,1,1,1,1,6,6,7,5,5,5,5,5,8,8,8,8,5,5,8,8,8,8,2,
2,1,1,1,1,1,1,1,1,1,1,1,1,5,5,5,5,5,2,6,6,7,5,5,5,5,5,5,8,8,5,5,5,5,8,8,5,2,
2,1,1,1,5,5,5,5,5,1,1,1,2,5,8,8,8,8,5,6,6,7,5,5,5,5,5,5,8,8,5,5,5,5,8,8,5,2,
2,1,1,1,5,8,8,8,5,1,1,1,1,1,8,8,8,8,5,6,6,7,5,5,5,5,5,5,7,7,5,5,5,5,7,7,5,2,
2,1,1,1,5,8,8,8,5,1,1,1,1,1,8,8,8,8,5,6,6,7,5,5,5,5,5,5,7,7,5,5,5,5,7,7,5,2,
2,1,1,1,5,8,8,8,5,2,1,1,2,5,8,8,8,8,5,6,6,7,5,5,5,5,5,2,1,1,2,5,5,2,1,1,2,2,
2,1,1,1,5,5,5,5,5,2,1,1,2,5,5,5,5,5,5,5,5,5,5,5,5,5,5,2,1,1,2,5,5,2,1,1,2,2,
2,1,1,1,2,5,5,5,5,5,1,1,1,2,1,1,1,5,7,1,1,2,1,1,1,5,1,1,1,1,1,1,1,1,1,1,1,2,
2,1,1,1,2,5,8,8,8,5,1,1,1,1,1,1,1,5,7,1,1,1,1,1,1,5,1,1,1,1,1,1,1,1,1,1,1,2,
2,2,2,2,2,5,8,8,8,5,5,1,1,1,1,1,1,5,7,1,1,1,1,1,1,5,1,1,1,1,1,1,1,1,1,1,1,2,
2,6,6,1,1,7,8,8,8,5,5,1,1,2,1,1,1,5,2,1,1,2,1,1,1,5,1,1,1,1,1,1,1,2,1,1,2,2,
2,6,6,1,1,5,5,5,5,5,5,1,1,5,1,1,1,7,1,1,1,5,1,1,1,2,5,5,5,5,5,5,5,2,1,1,2,2,
2,6,6,2,2,5,5,5,5,5,5,1,1,5,1,1,1,7,1,1,1,5,1,1,1,1,1,1,1,1,1,1,1,1,1,1,1,2,
2,6,6,6,6,5,8,8,8,8,5,1,1,5,1,1,1,7,1,1,1,5,1,1,1,1,1,1,1,1,1,1,1,1,1,1,1,2,
2,6,6,6,6,7,8,8,8,8,7,1,1,5,1,1,1,5,2,1,1,2,5,5,5,2,5,5,5,2,5,5,5,2,5,5,5,2,
2,6,6,6,6,7,8,8,8,8,7,1,1,5,1,1,1,5,7,1,1,1,1,1,1,1,1,1,1,1,1,1,1,1,1,1,1,2,
2,6,6,6,6,5,8,8,8,8,5,5,5,5,1,1,1,5,7,1,1,1,1,1,1,1,1,1,1,1,1,1,1,1,1,1,1,2,
2,5,5,5,5,5,5,5,5,5,5,5,5,5,5,5,5,5,7,1,1,2,5,5,5,2,5,5,5,2,5,5,5,2,5,5,5,2,
2,2,2,2,2,2,2,2,2,2,2,2,2,2,2,2,2,2,2,2,2,2,2,2,2,2,2,2,2,2,2,2,2,2,2,2,2,2
POSITION
SHIELDMAIDEN 150 400 1
SHIELDMAIDEN 150 450 2
SHIELDMAIDEN 100 400 3
SHIELDMAIDEN 100 450 4
BUNNY 320 330
BUNNY 370 290
BUNNY 360 350
BUNNY 340 530
BUNNY 410 550
BUNNY 380 580
BUNNY 780 280
BUNNY 850 320
BUNNY 870 250
BUNNY 130 790
BUNNY 230 830
BUNNY 170 870
BUNNY 340 790
BUNNY 340 890
BUNNY 990 890
BUNNY 1210 530
BUNNY 1170 710
BUNNY 1750 700
BUNNY 1750 750
BUNNY 1380 470
BUNNY 1520 470
BUNNY 1680 470
BUNNY 1820 470
BUNNY 1700 60
BUNNY 1790 90
VDOOR 600 200 1
VDOOR 1050 450 2
VDOOR 1250 650 3
DOOR 1700 600 4
VDOOR 900 0 10
DOOR 500 350 11
VDOOR 150 550 12
VDOOR 650 450 13
VDOOR 1050 800 14
VDOOR 1250 800 15
VDOOR 1450 800 16
VDOOR 1650 800 17
DOOR 1400 350 18
DOOR 1700 350 19
TRAPDOOR 1450 10 6
HANDLE 450 30 1
HANDLE 1160 820 2
HANDLE 1360 820 3
HANDLE 1560 820 4
HANDLE 1760 820 5
HANDLE 1360 30 6
LOCK 887 84 RED 1
LOCK 537 334 GREEN 3
LOCK 137 634 ORANGE 2
LOCK 637 534 BLUE 4
LOCK 1037 884 ALL 5
LOCK 1237 884 ALL 5
LOCK 1437 884 ALL 5
LOCK 1637 884 ALL 5
LOCK 1737 434 RED 1
LOCK 1437 434 BLUE 4
KEY 100 200 RED 1
KEY 700 200 RED 1
KEY 950 350 GREEN 3
KEY 1000 350 ORANGE 2
KEY 400 500 BLUE 4
KEY 900 450 ALL 5
KEY 1200 750 ALL 5
KEY 1800 700 ALL 5
KEY 1300 450 ALL 5
KEY 1800 50 BLUE 4
KEY 1800 900 RED 1
ENDOFFILE

note: this is not the actual tutorial level, more like a test level