LEVEL_INFORMATION
Tutorial_Beginning
TILES
2,2,2,2,2,2,2,2,2,2,2,2,2,2,2,2,2,2,2,
2,5,5,5,1,1,1,1,1,1,1,1,1,1,1,4,4,4,2,
2,5,5,5,1,1,1,1,1,1,1,1,1,1,1,3,3,3,2,
2,5,5,5,1,1,1,1,1,1,1,1,1,1,1,3,3,3,2,
2,1,1,1,1,1,1,1,1,1,1,1,1,1,1,1,1,1,2,
2,1,1,1,1,1,1,1,1,1,1,1,2,1,1,1,1,1,2,
2,1,1,1,1,1,2,1,1,1,1,1,1,1,1,1,1,1,2,
2,1,1,1,1,1,1,1,1,1,1,1,1,1,3,3,3,1,2,
2,1,1,1,3,3,3,3,3,3,3,3,3,3,3,1,1,1,2,
2,2,2,2,2,2,2,2,2,2,2,2,2,2,2,2,2,2,2
POSITION
SHIELDMAIDEN 500 500 1
SHIELDMAIDEN 600 500 2
HANDLE 900 300
DUMMY 950 600
BUNNY 1200 300
ENDOFFILE

note: this is not the actual tutorial level, more like a test level