LEVEL_INFORMATION
Level with a touch of beign a zoo (no animals were harmed during the making of the level)
TILES
2,2,2,2,2,2,2,2,2,2,2,2,2,2,2,2,2,2,2,2,2,2,2,2,2,2,2,2,2,2,2,2,2,2,2,2,2,2,
2,1,1,1,1,1,1,1,1,1,1,1,1,1,1,1,1,1,1,6,6,7,5,5,5,5,5,8,8,8,8,5,5,8,8,8,8,2,
2,1,1,1,1,1,1,1,1,1,1,1,1,1,1,1,1,1,1,6,6,7,5,5,5,5,5,8,8,8,8,5,5,8,8,8,8,2,
2,1,1,1,1,1,1,1,1,1,1,1,1,5,5,5,5,5,2,6,6,7,5,5,5,5,5,5,8,8,5,5,5,5,8,8,5,2,
2,1,1,1,5,5,5,5,5,1,1,1,2,5,8,8,8,8,5,6,6,7,5,5,5,5,5,5,8,8,5,5,5,5,8,8,5,2,
2,1,1,1,5,8,8,8,5,1,1,1,1,1,8,8,8,8,5,6,6,7,5,5,5,5,5,5,7,7,5,5,5,5,7,7,5,2,
2,1,1,1,5,8,8,8,5,1,1,1,1,1,8,8,8,8,5,6,6,7,5,5,5,5,5,5,7,7,5,5,5,5,7,7,5,2,
2,1,1,1,5,8,8,8,5,2,1,1,2,5,8,8,8,8,5,6,6,7,5,5,5,5,5,2,1,1,2,5,5,2,1,1,2,2,
2,1,1,1,5,5,5,5,5,2,1,1,2,5,5,5,5,5,5,5,5,5,5,5,5,5,5,2,1,1,2,5,5,2,1,1,2,2,
2,1,1,1,2,5,5,5,5,5,1,1,1,2,1,1,1,5,7,1,1,2,1,1,1,5,1,1,1,1,1,1,1,1,1,1,1,2,
2,1,1,1,2,5,8,8,8,5,1,1,1,1,1,1,1,5,7,1,1,1,1,1,1,5,1,1,1,1,1,1,1,1,1,1,1,2,
2,2,2,2,2,5,8,8,8,5,5,1,1,1,1,1,1,5,7,1,1,1,1,1,1,5,1,1,1,1,1,1,1,1,1,1,1,2,
2,6,6,1,1,7,8,8,8,5,5,1,1,2,1,1,1,5,2,1,1,2,1,1,1,5,1,1,1,1,1,1,1,2,1,1,2,2,
2,6,6,1,1,5,5,5,5,5,5,1,1,5,1,1,1,7,1,1,1,5,1,1,1,2,5,5,5,5,5,5,5,2,1,1,2,2,
2,6,6,2,2,5,5,5,5,5,5,1,1,5,1,1,1,7,1,1,1,5,1,1,1,1,1,1,1,1,1,1,1,1,1,1,1,2,
2,6,6,6,6,5,8,8,8,8,5,1,1,5,1,1,1,7,1,1,1,5,1,1,1,1,1,1,1,1,1,1,1,1,1,1,1,2,
2,6,6,6,6,7,8,8,8,8,7,1,1,5,1,1,1,5,2,1,1,2,5,5,5,2,5,5,5,2,5,5,5,2,5,5,5,2,
2,6,6,6,6,7,8,8,8,8,7,1,1,5,1,1,1,5,7,1,1,1,1,1,1,1,1,1,1,1,1,1,1,1,1,1,1,2,
2,6,6,6,6,5,8,8,8,8,5,5,5,5,1,1,1,5,7,1,1,1,1,1,1,1,1,1,1,1,1,1,1,1,1,1,1,2,
2,5,5,5,5,5,5,5,5,5,5,5,5,5,5,5,5,5,7,1,1,2,5,5,5,2,5,5,5,2,5,5,5,2,5,5,5,2,
2,2,2,2,2,2,2,2,2,2,2,2,2,2,2,2,2,2,2,2,2,2,2,2,2,2,2,2,2,2,2,2,2,2,2,2,2,2
POSITION
SHIELDMAIDEN 150 500 1
SHIELDMAIDEN 150 550 2
SHIELDMAIDEN 100 500 3
SHIELDMAIDEN 100 550 4
BUNNY 320 380
BUNNY 370 340
BUNNY 360 400
BUNNY 340 580
BUNNY 410 600
BUNNY 380 630
BUNNY 780 330
BUNNY 850 370
BUNNY 870 300
BUNNY 130 840
BUNNY 230 880
BUNNY 170 920
BUNNY 340 840
BUNNY 340 940
BUNNY 990 940
BUNNY 1210 580
BUNNY 1170 760
BUNNY 1750 750
BUNNY 1750 800
BUNNY 1380 520
BUNNY 1520 520
BUNNY 1680 520
BUNNY 1820 520
BUNNY 1700 110
BUNNY 1790 140
ENDOFFILE

note: this is not the actual tutorial level, more like a test level