LEVEL_INFORMATION
Icelevel - get the key to open the path to the trapdoor. Careful of the penguins.
TILES
2,2,2,2,2,2,2,2,2,2,2,2,2,2,2,2,2,2,2,2,2,2,2,2,2,2,2,2,2,2,2,2,2,2,2,2,2,2,
2,4,3,3,6,6,4,4,6,6,3,3,3,3,3,3,3,3,3,3,3,3,3,3,3,3,3,3,3,3,3,3,6,6,3,3,4,2,
2,3,3,3,3,3,3,4,4,4,3,3,3,3,3,3,4,6,6,6,6,4,4,3,3,3,3,3,3,3,3,3,3,3,3,3,3,2,
2,6,3,3,6,6,3,3,3,3,3,3,3,3,3,3,4,6,6,6,6,4,3,3,3,6,6,4,3,3,3,3,6,6,3,3,6,2,
2,6,3,3,6,6,3,3,3,3,3,3,3,3,3,3,3,4,6,6,4,3,3,3,3,3,3,3,3,3,4,3,6,6,3,3,6,2,
2,4,3,3,3,3,3,3,3,3,3,3,3,3,3,3,3,3,3,3,3,3,3,3,3,3,3,3,3,3,3,3,3,3,3,3,4,2,
2,4,3,3,3,4,3,6,6,3,3,3,3,6,6,3,3,3,3,3,3,3,3,3,3,6,6,3,3,3,3,3,3,3,3,3,4,2,
2,4,3,3,3,4,3,6,6,3,3,4,4,3,3,3,3,3,3,3,3,3,3,3,3,3,4,3,3,3,3,3,3,3,3,3,4,2,
2,4,3,3,4,3,3,6,6,4,4,6,6,3,3,3,3,3,3,3,3,3,3,3,3,3,3,3,3,3,3,3,3,3,3,3,4,2,
2,4,3,3,3,3,3,4,4,3,3,3,3,3,3,3,3,3,1,1,3,3,3,3,3,3,3,3,3,3,3,3,3,3,3,3,4,2,
2,4,3,3,3,3,3,3,3,3,3,3,3,3,3,3,3,3,1,1,3,3,3,3,3,3,3,3,3,3,3,3,3,3,3,3,4,2,
2,4,3,3,3,3,3,3,3,3,3,3,3,3,3,3,3,3,3,3,3,3,3,3,3,4,3,3,3,3,3,3,3,3,3,3,4,2,
2,4,3,3,4,3,3,6,6,3,3,3,3,3,3,3,3,3,3,3,3,3,3,3,3,3,6,6,3,3,3,3,3,3,3,3,4,2,
2,4,3,3,3,4,3,6,6,3,3,3,3,3,3,3,3,3,3,3,3,3,3,3,3,3,6,6,3,3,3,3,3,3,3,3,4,2,
2,4,3,3,3,3,3,3,3,3,3,3,3,3,3,3,3,3,3,3,3,3,3,3,3,3,3,3,3,3,3,4,3,3,3,3,4,2,
2,4,3,3,3,3,3,3,3,3,3,3,3,3,3,3,4,6,6,6,6,4,3,3,3,3,3,3,3,3,3,3,3,3,3,3,4,2,
2,6,3,3,6,6,3,3,3,3,3,3,3,3,3,3,6,6,6,6,6,6,3,3,3,3,3,3,3,3,3,3,6,6,3,3,6,2,
2,6,3,3,6,6,3,3,3,3,3,3,3,3,3,3,4,4,4,4,4,4,3,3,3,3,3,3,3,3,3,3,6,6,3,3,6,2,
2,3,3,3,3,3,3,3,3,3,3,3,3,3,3,3,3,3,3,3,3,3,3,3,3,3,3,3,3,3,3,3,3,3,3,3,3,2,
2,4,3,3,6,6,4,3,3,3,3,3,3,3,3,3,3,3,3,3,3,3,6,6,3,3,3,3,3,3,3,4,6,6,3,3,4,2,
2,2,2,2,2,2,2,2,2,2,2,2,2,2,2,2,2,2,2,2,2,2,2,2,2,2,2,2,2,2,2,2,2,2,2,2,2,2
POSITION
SHIELDMAIDEN 900 730 1
SHIELDMAIDEN 900 780 2
SHIELDMAIDEN 990 730 3
SHIELDMAIDEN 990 780 4
PENGUIN 600 150
PENGUIN 1750 300
PENGUIN 150 300
DOOR 900 450 10
DOOR 350 350 1
DOOR 350 600 2
DOOR 1300 600 3
TRAPDOOR 950 50 5
LOCK 937 534 ALL 5
KEY 550 400 ALL 5
HANDLE 410 20 1
HANDLE 1610 800 2
HANDLE 210 800 3
HANDLE 860 80 99
ENDOFFILE

note: this is not the actual tutorial level, more like a test level