LEVEL_INFORMATION
sewers, wut?
TILES
2,2,2,2,2,2,2,2,2,2,2,2,2,2,2,2,2,2,2,2,2,2,2,2,2,2,2,2,2,2,2,2,2,2,2,2,2,2,
2,1,1,1,5,5,1,1,1,1,1,1,1,1,2,1,1,1,1,1,1,1,2,1,1,1,2,1,1,1,5,5,5,5,1,1,1,2,
2,1,1,1,5,5,1,1,1,1,1,1,1,1,2,1,1,1,1,1,1,1,2,1,1,1,2,1,1,1,5,5,5,5,1,1,1,2,
2,1,1,1,5,5,1,1,1,1,2,1,1,2,2,1,1,2,2,2,2,2,2,1,1,1,2,1,1,2,5,5,5,5,1,1,1,2,
2,1,1,2,5,5,2,2,2,2,2,1,1,1,1,1,1,1,1,1,1,1,1,1,1,1,1,1,1,1,7,2,2,7,1,1,1,2,
2,1,1,2,5,5,1,1,1,1,2,1,1,1,1,1,1,1,1,1,1,1,1,1,1,1,1,1,1,1,6,1,1,6,1,1,1,2,
2,1,1,1,5,5,1,1,1,1,2,1,1,2,1,1,1,1,1,1,1,1,1,1,1,1,1,1,1,1,6,1,1,6,1,1,1,2,
2,1,1,1,5,5,2,1,1,2,2,1,1,2,1,1,2,2,2,2,2,2,2,1,1,1,1,1,1,1,7,2,2,7,2,2,2,2,
2,1,1,1,6,6,1,1,1,1,2,1,1,2,1,1,1,1,1,2,1,1,2,1,1,2,1,1,2,2,5,5,5,5,1,1,1,2,
2,1,1,1,6,6,1,1,1,1,2,1,1,2,1,1,1,1,1,2,1,1,2,1,1,2,1,1,1,1,5,5,5,5,1,1,1,2,
2,1,1,1,5,5,1,1,1,1,2,1,1,2,2,2,2,2,2,2,1,1,2,2,2,2,1,1,1,1,5,5,5,5,1,1,1,2,
2,1,1,1,5,5,1,1,1,1,1,1,1,1,1,1,1,1,1,1,1,1,1,1,2,1,1,1,1,1,5,5,5,5,2,1,1,2,
2,1,1,1,5,5,1,1,1,1,1,1,1,1,1,1,1,1,1,1,1,1,1,1,2,1,1,1,1,1,5,5,5,5,2,1,1,2,
2,1,1,1,5,5,1,1,1,1,1,1,1,1,1,1,1,1,2,1,1,1,1,1,2,1,1,1,1,1,5,5,5,5,1,1,1,2,
2,6,6,7,5,5,5,5,5,5,5,5,5,7,7,5,5,5,5,5,5,5,5,5,5,7,6,6,7,5,5,5,5,5,1,1,1,2,
2,6,6,2,5,5,5,5,5,5,5,5,5,7,7,5,5,5,5,5,5,5,5,5,5,2,6,6,2,5,5,5,5,5,2,1,1,2,
2,6,6,2,5,5,5,5,5,5,5,5,5,7,7,5,5,5,5,5,5,5,5,5,5,2,6,6,2,5,5,5,5,5,2,1,1,2,
2,6,6,7,5,5,5,5,5,5,5,5,5,7,7,5,5,5,5,5,5,5,5,5,5,7,6,6,7,5,5,5,5,5,1,1,1,2,
2,1,1,1,1,1,1,1,1,1,5,5,1,1,1,1,1,1,1,1,1,1,1,2,1,1,1,1,1,1,1,1,1,1,1,1,1,2,
2,1,1,1,1,1,1,1,1,1,5,5,1,1,1,1,1,1,1,1,1,1,1,2,1,1,1,1,1,1,1,1,1,1,1,1,1,2,
2,2,2,2,2,2,2,2,2,2,2,2,2,2,2,2,2,2,2,2,2,2,2,2,2,2,2,2,2,2,2,2,2,2,2,2,2,2
POSITION
SHIELDMAIDEN 100 80 1
SHIELDMAIDEN 150 80 2
SHIELDMAIDEN 1400 80 3
SHIELDMAIDEN 1450 80 4
BUNNY 110 440
BUNNY 850 70
BUNNY 1300 620
BUNNY 1400 620
BUNNY 1150 250
BUNNY 1200 300
BUNNY 1080 600
BUNNY 550 600
BUNNY 700 600
BUNNY 350 500
PENGUIN 130 600
PENGUIN 950 950
DOOR 50 200 1
DOOR 50 750 2
DOOR 350 300 3
DOOR 550 450 4
DOOR 550 300 5
VDOOR 650 150 6
DOOR 750 100 1
DOOR 700 300 10
VDOOR 900 500 9
DOOR 1300 400 10
DOOR 1750 750 17 
DOOR 1750 550 12
VDOOR 1550 200 13
DOOR 1300 750 14
TRAPDOOR 1750 50 11
HANDLE 110 100 1
HANDLE 1210 50 2
HANDLE 1160 400 3
HANDLE 900 250 4
HANDLE 1060 900 6
HANDLE 310 50 10
HANDLE 1760 250 99
HANDLE 1010 50 12
LOCK 587 384 ALL 5
LOCK 1537 284 RED 1
LOCK 887 584 ALL 5
LOCK 1337 734 BLUE 2
LOCK 1787 634 GREEN 3
LOCK 1787 834 ORANGE 4
KEY 450 250 ALL 5
KEY 1700 400 RED 1
KEY 1700 650 ALL 5
KEY 450 900 BLUE 2
KEY 1150 650 GREEN 3
KEY 900 450 ORANGE 4
ENDOFFILE

note: this is not the actual tutorial level, more like a test level