LEVEL_INFORMATION
sewers, wut?
TILES
2,2,2,2,2,2,2,2,2,2,2,2,2,2,2,2,2,2,2,2,2,2,2,2,2,2,2,2,2,2,2,2,2,2,2,2,2,2,
2,1,1,1,5,5,1,1,1,1,1,1,1,1,1,1,5,1,1,1,1,1,2,1,1,1,1,1,1,1,5,5,5,5,1,1,1,2,
2,1,1,1,5,5,1,1,1,1,1,1,1,1,1,1,5,1,1,1,1,1,2,1,1,1,1,1,1,1,5,5,5,5,1,1,1,2,
2,1,1,1,5,5,1,1,2,2,2,2,2,2,2,2,5,5,5,5,1,1,2,1,1,1,1,1,1,1,5,5,5,5,1,1,1,2,
2,1,1,1,5,5,1,1,2,1,1,1,1,1,1,1,1,1,1,5,1,1,2,2,2,2,1,1,2,2,5,5,5,5,1,1,1,2,
2,1,1,2,5,5,1,1,2,1,1,1,1,1,1,1,1,1,1,5,1,1,1,1,1,1,1,1,1,1,5,5,5,5,1,1,1,2,
2,1,1,1,5,5,1,1,2,1,1,1,1,1,2,1,1,1,1,5,1,1,1,1,1,1,1,1,1,1,5,5,5,5,1,1,1,2,
2,1,1,1,5,5,1,1,2,1,1,1,1,1,2,1,1,1,1,5,1,1,1,1,1,1,1,1,1,1,5,5,5,5,1,1,1,2,
2,1,1,1,6,6,1,1,2,1,1,1,1,1,2,1,1,1,1,5,1,1,2,2,2,2,2,1,1,2,5,5,5,5,1,1,1,2,
2,1,1,1,6,6,1,1,2,1,1,1,1,1,2,1,1,1,1,5,1,1,2,1,1,1,1,1,1,1,5,5,5,5,1,1,1,2,
2,1,1,1,5,5,1,1,2,1,1,2,2,2,2,5,5,5,5,5,1,1,2,1,1,1,1,1,1,1,5,5,5,5,2,1,1,2,
2,1,1,1,5,5,1,1,1,1,1,1,1,1,1,6,6,1,1,1,1,1,2,1,1,2,2,2,2,2,5,5,5,5,2,1,1,2,
2,1,1,1,5,5,1,1,1,1,1,1,1,1,1,6,6,1,1,1,1,1,2,1,1,1,1,1,1,1,5,5,5,5,1,1,1,2,
2,1,1,1,5,5,1,1,1,1,1,1,1,1,1,6,6,1,1,1,1,1,2,1,1,1,1,1,1,1,5,5,5,5,1,1,1,2,
2,6,6,7,5,5,5,5,5,5,5,5,5,5,5,5,5,5,5,5,5,5,5,5,5,7,6,6,7,5,5,5,5,5,1,1,1,2,
2,6,6,2,5,5,5,5,5,5,5,5,5,5,5,5,5,5,5,5,5,5,5,5,5,2,6,6,2,5,5,5,5,5,1,1,1,2,
2,6,6,2,5,5,5,5,5,5,5,5,5,5,5,5,5,5,5,5,5,5,5,5,5,2,6,6,2,5,5,5,5,5,1,1,1,2,
2,6,6,7,5,5,5,5,5,5,5,5,5,5,5,5,5,5,5,5,5,5,5,5,5,7,6,6,7,5,5,5,5,5,1,1,1,2,
2,1,1,1,1,1,1,1,1,1,1,1,1,1,1,1,1,1,1,1,1,1,1,1,1,1,1,1,1,1,1,1,1,1,1,1,1,2,
2,1,1,1,1,1,1,1,1,1,1,1,1,1,1,1,1,1,1,1,1,1,1,1,1,1,1,1,1,1,1,1,1,1,1,1,1,2,
2,2,2,2,2,2,2,2,2,2,2,2,2,2,2,2,2,2,2,2,2,2,2,2,2,2,2,2,2,2,2,2,2,2,2,2,2,2
POSITION
SHIELDMAIDEN 150 100 1
SHIELDMAIDEN 150 150 2
ENDOFFILE

note: this is not the actual tutorial level, more like a test level