LEVEL_INFORMATION
Hotel dragon's Den - with the most beautiful view of the tower
TILES
2,2,2,2,2,2,2,2,2,2,2,2,2,2,2,2,2,2,2,2,2,2,2,2,2,2,2,2,2,2,2,2,2,2,2,2,2,2,
2,1,1,1,1,1,1,1,2,1,1,1,1,1,2,1,1,1,1,2,1,1,1,2,1,1,1,1,2,1,1,1,1,1,1,1,1,2,
2,1,1,1,1,1,1,1,2,1,1,1,1,1,2,1,1,1,1,1,1,1,1,2,1,1,1,1,2,1,1,1,1,1,1,1,1,2,
2,1,1,2,2,2,1,1,2,1,1,2,1,1,2,1,1,1,1,1,1,1,1,2,1,1,1,1,2,1,1,2,2,2,2,2,2,2,
2,1,1,1,1,2,1,1,2,1,1,2,1,1,2,1,1,1,1,2,1,1,1,2,1,1,1,1,2,1,1,2,1,1,1,1,1,2,
2,1,1,1,1,2,1,1,2,2,2,2,1,1,2,1,1,2,2,2,2,2,2,2,2,1,1,2,2,1,1,2,1,1,1,1,1,2,
2,1,1,1,1,2,1,1,1,1,1,1,1,1,1,1,1,1,1,1,1,1,1,1,1,1,1,1,1,1,1,2,2,2,2,1,1,2,
2,1,1,1,1,2,1,1,1,1,1,1,1,1,1,1,1,1,1,1,1,1,1,1,1,1,1,1,1,1,1,1,1,1,1,1,1,2,
2,2,2,1,1,2,1,1,1,1,1,1,1,1,1,1,1,1,1,1,1,1,1,1,1,1,1,1,1,1,1,1,1,1,1,1,1,2,
2,1,1,1,1,2,1,1,2,1,1,2,2,2,2,2,2,2,2,2,2,2,2,2,2,2,2,2,1,1,1,2,1,1,1,1,1,2,
2,1,1,1,1,2,1,1,2,1,1,2,1,1,1,1,1,1,1,2,1,1,1,1,1,1,1,2,1,1,1,2,2,2,2,2,2,2,
2,1,1,1,1,2,1,1,2,1,1,1,1,1,1,1,1,1,1,1,1,1,1,1,1,1,1,2,1,1,1,2,1,1,1,1,1,2,
2,2,2,2,2,2,1,1,2,1,1,1,1,1,1,2,1,1,1,1,1,1,1,2,1,1,1,2,1,1,1,2,1,1,1,1,1,2,
2,1,1,1,1,1,1,1,2,2,2,2,2,2,2,2,2,2,2,2,2,2,2,2,2,2,2,2,1,1,1,2,2,2,1,1,2,2,
2,1,1,1,1,1,1,1,1,1,1,1,1,1,1,1,1,1,1,1,1,1,1,1,1,1,1,1,1,1,1,1,1,1,1,1,1,2,
2,1,1,1,2,1,1,1,1,1,1,1,1,1,1,1,1,1,1,1,1,1,1,1,1,1,1,1,1,1,1,1,1,1,1,1,1,2,
2,2,2,2,2,2,1,1,2,2,2,1,1,2,2,2,1,1,2,1,1,2,2,2,2,1,1,2,2,1,1,2,1,1,1,1,1,2,
2,1,1,1,1,2,1,1,2,1,1,1,1,2,1,1,1,1,2,1,1,2,1,1,2,1,1,1,2,1,1,2,2,2,2,2,2,2,
2,1,1,1,1,1,1,1,2,1,1,1,1,2,1,1,1,1,2,1,1,1,1,1,2,1,1,1,2,1,1,1,1,1,1,1,1,2,
2,1,1,1,1,1,1,1,2,1,1,1,1,2,1,1,1,1,2,1,1,1,1,1,2,1,1,1,2,1,1,1,1,1,1,1,1,2,
2,2,2,2,2,2,2,2,2,2,2,2,2,2,2,2,2,2,2,2,2,2,2,2,2,2,2,2,2,2,2,2,2,2,2,2,2,2
POSITION
SHIELDMAIDEN 200 40 1
SHIELDMAIDEN 250 40 2
SHIELDMAIDEN 200 90 3
SHIELDMAIDEN 250 90 4
BUNNY 150 300
BUNNY 100 530
BUNNY 100 700
BUNNY 100 900
BUNNY 500 900
BUNNY 750 900
BUNNY 1300 950
BUNNY 1730 780
BUNNY 1810 750
BUNNY 1700 400
BUNNY 1740 380
BUNNY 1250 70
BUNNY 1270 150
BUNNY 1320 80
BUNNY 820 110
BUNNY 630 100
PENGUIN 300 700
PENGUIN 1450 350
DOOR 50 150 1
DOOR 150 400 2
VDOOR 200 600 3
DOOR 300 800 4
DOOR 550 800 5
DOOR 800 800 6
DOOR 950 800 7
VDOOR 1050 850 8
DOOR 1250 800 9
DOOR 1450 800 10
VDOOR 1550 650 11
DOOR 1700 600 12
VDOOR 1550 300 13
DOOR 1750 250 14
DOOR 1250 200 15
DOOR 750 200 16
VDOOR 950 50 17
DOOR 600 200 18
VDOOR 550 0 19
DOOR 450 450 20
VDOOR 550 500 21
VDOOR 750 450 22
VDOOR 950 500 23
VDOOR 1150 450 24
TRAPDOOR 1250 450 25
HANDLE 1260 550 25
LOCK 487 434 ALL 5
LOCK 537 584 RED 1
LOCK 737 534 ORANGE 2 
LOCK 937 584 GREEN 3
LOCK 1137 534 BLUE 4
ENDOFFILE

note: this is not the actual tutorial level, more like a test level