LEVEL_INFORMATION
Tutorial_Beginning
TILES
2,2,2,2,2,2,2,2,2,2,2,2,2,2,2,2,2,2,2,
2,5,5,5,1,1,1,1,2,1,1,1,1,1,2,1,1,1,2,
2,5,5,5,1,1,1,1,2,1,1,1,1,1,2,1,1,1,2,
2,5,5,5,1,1,2,1,2,1,1,1,2,1,2,1,1,1,2,
2,1,1,1,1,1,2,1,2,1,1,2,1,1,2,1,1,1,2,
2,1,1,1,1,1,2,1,2,1,1,2,1,2,1,1,1,1,2,
2,1,1,1,1,1,2,1,1,1,1,2,1,1,2,1,2,1,2,
2,1,1,1,1,1,2,1,2,2,2,2,1,1,1,2,2,1,2,
2,1,1,1,1,1,2,1,1,1,1,2,1,1,1,1,1,1,2,
2,2,2,2,2,2,2,2,2,2,2,2,2,2,2,2,2,2,2
POSITION
SHIELDMAIDEN 300 600 1
SHIELDMAIDEN 200 500 2
DUMMY 900 600
BUNNY 1500 500
ENDOFFILE

note: this is not the actual tutorial level, more like a test level