LEVEL_INFORMATION
Template level - nice beginning point for designing new levels
TILES
2,2,2,2,2,2,2,2,2,2,2,2,2,2,2,2,2,2,2,2,2,2,2,2,2,2,2,2,2,2,2,2,2,2,2,2,2,2,
2,4,3,6,6,3,3,3,3,3,3,3,3,3,3,3,4,4,4,4,4,4,3,3,3,3,3,3,3,3,3,3,3,6,6,3,4,2,
2,3,3,3,3,3,3,3,3,3,3,3,3,3,3,3,4,6,6,6,6,4,3,3,3,3,3,3,3,3,3,3,3,3,3,3,3,2,
2,6,3,6,6,3,3,3,3,3,3,3,3,3,3,3,4,6,6,6,6,4,3,3,3,3,3,3,3,3,3,3,3,6,6,3,6,2,
2,6,3,6,6,3,3,3,3,3,3,3,3,3,3,3,3,4,6,6,4,3,3,3,3,3,3,3,3,3,3,3,3,6,6,3,6,2,
2,4,3,3,3,3,3,3,3,3,3,3,3,3,3,3,3,3,3,3,3,3,3,3,3,3,3,3,3,3,3,3,3,3,3,3,4,2,
2,4,3,3,3,3,3,3,3,3,3,3,3,3,3,3,3,3,3,3,3,3,3,3,3,3,3,3,3,3,3,3,3,3,3,3,4,2,
2,4,3,3,3,3,3,3,3,3,3,3,3,3,3,3,3,3,3,3,3,3,3,3,3,3,3,3,3,3,3,3,3,3,3,3,4,2,
2,4,3,3,3,3,3,3,3,3,3,3,3,3,3,3,3,3,3,3,3,3,3,3,3,3,3,3,3,3,3,3,3,3,3,3,4,2,
2,4,3,3,3,3,3,3,3,3,3,3,3,3,3,3,3,3,2,2,3,3,3,3,3,3,3,3,3,3,3,3,3,3,3,3,4,2,
2,4,3,3,3,3,3,3,3,3,3,3,3,3,3,3,3,3,2,2,3,3,3,3,3,3,3,3,3,3,3,3,3,3,3,3,4,2,
2,4,3,3,3,3,3,3,3,3,3,3,3,3,3,3,3,3,3,3,3,3,3,3,3,3,3,3,3,3,3,3,3,3,3,3,4,2,
2,4,3,3,3,3,3,3,3,3,3,3,3,3,3,3,3,3,3,3,3,3,3,3,3,3,3,3,3,3,3,3,3,3,3,3,4,2,
2,4,3,3,3,3,3,3,3,3,3,3,3,3,3,3,3,3,3,3,3,3,3,3,3,3,3,3,3,3,3,3,3,3,3,3,4,2,
2,4,3,3,3,3,3,3,3,3,3,3,3,3,3,3,3,3,3,3,3,3,3,3,3,3,3,3,3,3,3,3,3,3,3,3,4,2,
2,4,3,3,3,3,3,3,3,3,3,3,3,3,3,3,4,6,6,6,6,4,3,3,3,3,3,3,3,3,3,3,3,3,3,3,4,2,
2,6,3,6,6,3,3,3,3,3,3,3,3,3,3,3,6,6,6,6,6,6,3,3,3,3,3,3,3,3,3,3,3,6,6,3,6,2,
2,6,3,6,6,3,3,3,3,3,3,3,3,3,3,3,6,6,6,6,6,6,3,3,3,3,3,3,3,3,3,3,3,6,6,3,6,2,
2,3,3,3,3,3,3,3,3,3,3,3,3,3,3,3,3,3,3,3,3,3,3,3,3,3,3,3,3,3,3,3,3,3,3,3,3,2,
2,4,3,6,6,3,3,3,3,3,3,3,3,3,3,3,3,3,3,3,3,3,3,3,3,3,3,3,3,3,3,3,3,6,6,3,4,2,
2,2,2,2,2,2,2,2,2,2,2,2,2,2,2,2,2,2,2,2,2,2,2,2,2,2,2,2,2,2,2,2,2,2,2,2,2,2
POSITION
SHIELDMAIDEN 900 800 1
SHIELDMAIDEN 950 800 2
ENDOFFILE

note: this is not the actual tutorial level, more like a test level