LEVEL_INFORMATION
Test_Level - Made by Jeff
TILES
2,2,2,2,2,2,2,2,2,2,2,2,2,2,2,2,2,2,2,2,2,2,2,2,2,2,2,2,2,2,2,2,2,2,2,2,2,2,
2,1,1,1,1,1,1,1,1,1,1,1,5,6,6,6,5,7,8,8,7,5,6,6,6,5,1,1,1,1,1,1,1,1,1,1,1,2,
2,1,1,1,1,1,1,1,1,1,1,1,5,6,6,6,5,7,8,8,7,5,6,6,6,5,1,1,1,1,1,1,1,1,1,1,1,2,
2,1,1,1,5,4,1,1,1,2,1,1,5,6,6,5,5,7,8,8,7,5,5,6,6,5,1,1,2,1,1,1,4,5,1,1,1,2,
2,1,1,1,4,5,1,1,5,5,2,5,5,6,6,6,6,7,8,8,7,6,6,6,6,5,5,2,5,5,1,1,5,4,1,1,1,2,
2,1,1,1,1,1,1,1,4,3,3,3,6,6,6,6,6,7,8,8,7,6,6,6,6,6,3,3,3,4,1,1,1,1,1,1,1,2,
2,1,1,1,1,1,1,1,5,3,3,5,2,2,2,2,2,2,2,2,2,2,2,2,2,2,5,3,3,5,1,1,1,1,1,1,1,2,
2,3,3,3,3,2,1,1,5,3,3,4,3,3,3,7,6,6,4,5,6,6,7,3,3,3,4,3,3,5,1,1,2,3,3,3,3,2,
2,3,3,3,3,2,6,6,5,3,3,5,3,3,5,7,6,6,5,5,6,6,7,5,3,3,5,3,3,5,6,6,2,3,3,3,3,2,
2,1,1,3,3,2,5,4,5,3,3,5,3,3,5,7,6,6,4,5,6,6,7,5,3,3,5,3,3,4,5,5,2,3,3,1,1,2,
2,3,3,3,3,3,3,3,3,3,3,2,6,6,5,7,6,6,5,4,6,6,7,5,6,6,2,3,3,3,3,3,3,3,3,3,3,2,
2,1,1,3,3,2,5,5,5,5,2,5,5,5,5,7,6,6,5,5,6,6,7,5,5,5,5,2,5,5,5,4,2,3,3,1,1,2,
2,3,3,3,3,2,1,1,6,6,6,6,6,6,4,3,3,3,4,3,3,3,3,4,6,6,6,6,6,6,1,1,2,3,3,3,3,2,
2,3,3,3,3,2,1,1,6,6,6,6,6,6,4,3,3,3,3,3,3,3,3,3,6,6,6,6,6,6,1,1,2,3,3,3,3,2,
2,1,1,1,1,1,1,1,5,6,6,6,6,6,4,3,3,3,4,4,4,3,3,4,6,6,6,6,6,5,1,1,1,1,1,1,1,2,
2,1,1,1,1,1,1,1,5,6,6,6,6,6,3,3,3,3,3,3,3,3,3,4,6,6,6,6,6,5,1,1,1,1,1,1,1,2,
2,1,1,1,4,5,5,4,2,5,5,5,5,5,4,4,3,3,3,3,4,3,3,4,5,5,5,5,5,2,4,5,5,4,1,1,1,2,
2,1,1,1,5,4,3,3,6,6,6,6,6,6,3,4,3,3,3,3,3,3,3,4,6,6,6,6,6,6,3,3,4,5,1,1,1,2,
2,1,1,1,1,1,3,3,6,6,6,6,6,6,3,3,3,3,3,4,3,3,3,4,6,6,6,6,6,6,3,3,1,1,1,1,1,2,
2,1,1,1,1,1,3,3,2,6,6,6,6,6,3,3,4,4,3,4,3,3,3,3,6,6,6,6,6,2,3,3,1,1,1,1,1,2,
2,2,2,2,2,2,2,2,2,2,2,2,2,2,2,2,2,2,2,2,2,2,2,2,2,2,2,2,2,2,2,2,2,2,2,2,2,2
POSITION
SHIELDMAIDEN 1800 100 1
SHIELDMAIDEN 100 100 2
SHIELDMAIDEN 100 900 3
SHIELDMAIDEN 1800 900 4
BUNNY 350 900
BUNNY 350 200
BUNNY 350 250
BUNNY 550 120
BUNNY 650 650
BUNNY 650 900
BUNNY 720 40
BUNNY 750 80
BUNNY 760 50
BUNNY 790 350
BUNNY 810 400
BUNNY 860 380
BUNNY 950 160
BUNNY 1020 350
BUNNY 1050 390
BUNNY 1090 370
BUNNY 1160 40
BUNNY 1180 50
BUNNY 1170 80
BUNNY 1280 660
BUNNY 1280 910
BUNNY 1340 120
BUNNY 1530 190
BUNNY 1550 230
BUNNY 1550 900
ENDOFFILE

note: this is not the actual tutorial level, more like a test level