LEVEL_INFORMATION
Hotel dragon's Den - with the most beautiful view of the tower
TILES
2,2,2,2,2,2,2,2,2,2,2,2,2,2,2,2,2,2,2,2,2,2,2,2,2,2,2,2,2,2,2,2,2,2,2,2,2,2,
2,1,1,1,1,1,1,1,2,1,1,1,1,1,2,1,1,1,1,2,1,1,1,2,1,1,1,1,2,1,1,1,1,1,1,1,1,2,
2,1,1,1,1,1,1,1,2,1,1,1,1,1,2,1,1,1,1,1,1,1,1,2,1,1,1,1,2,1,1,1,1,1,1,1,1,2,
2,1,1,2,2,2,1,1,2,1,1,2,1,1,2,1,1,1,1,1,1,1,1,2,1,1,1,1,2,1,1,2,2,2,2,2,2,2,
2,1,1,1,1,2,1,1,2,1,1,2,1,1,2,1,1,1,1,2,1,1,1,2,1,1,1,1,2,1,1,2,1,1,1,1,1,2,
2,1,1,1,1,2,1,1,2,2,2,2,1,1,2,1,1,2,2,2,2,2,2,2,2,1,1,2,2,1,1,2,1,1,1,1,1,2,
2,1,1,1,1,2,1,1,1,1,1,1,1,1,1,1,1,1,1,1,1,1,1,1,1,1,1,1,1,1,1,2,2,2,2,1,1,2,
2,1,1,1,1,2,1,1,1,1,1,1,1,1,1,1,1,1,1,1,1,1,1,1,1,1,1,1,1,1,1,1,1,1,1,1,1,2,
2,2,2,1,1,2,1,1,1,1,1,1,1,1,1,1,1,1,1,1,1,1,1,1,1,1,1,1,1,1,1,1,1,1,1,1,1,2,
2,1,1,1,1,2,1,1,2,1,1,2,2,2,2,2,2,2,2,2,2,2,2,2,2,2,2,2,1,1,1,2,1,1,1,1,1,2,
2,1,1,1,1,2,1,1,2,1,1,2,1,1,1,1,1,1,1,2,1,1,1,1,1,1,1,2,1,1,1,2,2,2,2,2,2,2,
2,1,1,1,1,2,1,1,2,1,1,1,1,1,1,1,1,1,1,1,1,1,1,1,1,1,1,2,1,1,1,2,1,1,1,1,1,2,
2,2,2,2,2,2,1,1,2,1,1,1,1,1,1,2,1,1,1,1,1,1,1,2,1,1,1,2,1,1,1,2,1,1,1,1,1,2,
2,1,1,1,1,1,1,1,2,2,2,2,2,2,2,2,2,2,2,2,2,2,2,2,2,2,2,2,1,1,1,2,2,2,1,1,2,2,
2,1,1,1,1,1,1,1,1,1,1,1,1,1,1,1,1,1,1,1,1,1,1,1,1,1,1,1,1,1,1,1,1,1,1,1,1,2,
2,1,1,1,2,1,1,1,1,1,1,1,1,1,1,1,1,1,1,1,1,1,1,1,1,1,1,1,1,1,1,1,1,1,1,1,1,2,
2,2,2,2,2,2,1,1,2,2,2,1,1,2,2,2,1,1,2,1,1,2,2,2,2,1,1,2,2,1,1,2,1,1,1,1,1,2,
2,1,1,1,1,2,1,1,2,1,1,1,1,2,1,1,1,1,2,1,1,2,1,1,2,1,1,1,2,1,1,2,2,2,2,2,2,2,
2,1,1,1,1,1,1,1,2,1,1,1,1,2,1,1,1,1,2,1,1,1,1,1,2,1,1,1,2,1,1,1,1,1,1,1,1,2,
2,1,1,1,1,1,1,1,2,1,1,1,1,2,1,1,1,1,2,1,1,1,1,1,2,1,1,1,2,1,1,1,1,1,1,1,1,2,
2,2,2,2,2,2,2,2,2,2,2,2,2,2,2,2,2,2,2,2,2,2,2,2,2,2,2,2,2,2,2,2,2,2,2,2,2,2
POSITION
SHIELDMAIDEN 200 40 1
SHIELDMAIDEN 250 40 2
SHIELDMAIDEN 200 90 3
SHIELDMAIDEN 250 90 4
BUNNY 150 300
BUNNY 100 530
BUNNY 100 700
BUNNY 100 900
BUNNY 500 900
BUNNY 750 900
BUNNY 1300 950
BUNNY 1730 780
BUNNY 1810 750
BUNNY 1700 400
BUNNY 1740 380
BUNNY 1250 70
BUNNY 1270 150
BUNNY 1320 80
BUNNY 820 110
BUNNY 630 100
PENGUIN 300 700
PENGUIN 1450 350
DOOR 50 150 12
VDOOR 200 600 14
DOOR 300 800 20
DOOR 550 800 11
DOOR 800 800 21
DOOR 950 800 10
DOOR 1250 800 13
DOOR 1450 800 22
VDOOR 1550 650 13
DOOR 1700 600 12
VDOOR 1550 300 23
DOOR 1750 250 15
DOOR 1250 200 24
DOOR 750 200 11
DOOR 600 200 10
DOOR 450 450 25
VDOOR 550 500 26
VDOOR 750 450 27
VDOOR 950 500 28
VDOOR 1150 450 29
TRAPDOOR 1250 450 30
HANDLE 1760 40 10
HANDLE 80 860 11
HANDLE 60 650 12
HANDLE 1760 910 13
HANDLE 1260 40 14
HANDLE 70 480 15
HANDLE 1260 550 99
LOCK 480 424 ALL 5
LOCK 580 574 RED 1
LOCK 730 524 ORANGE 4
LOCK 930 574 GREEN 3
LOCK 1130 524 BLUE 2
LOCK 330 768 GREEN 3
LOCK 830 768 ORANGE 4
LOCK 1480 768 RED 1
LOCK 1280 268 BLUE 2
LOCK 1530 374 ALL 5
KEY 200 550 ALL 5
KEY 1600 250 ALL 5
KEY 50 50 RED 1
KEY 350 50 ORANGE 4
KEY 50 100 GREEN 3
KEY 350 100 BLUE 2
KEY 450 950 RED 1
KEY 1600 550 ORANGE 4
KEY 1100 200 GREEN 3
KEY 1150 850 BLUE 2
ENDOFFILE

note: this is not the actual tutorial level, more like a test level