LEVEL_INFORMATION
Tutorial_Beginning
TILES
2,2,2,2,2,2,2,2,2,2,2,2,2,2,2,2,2,2,2,
2,5,5,5,1,1,1,1,1,1,1,1,1,1,1,4,4,4,2,
2,5,5,5,1,1,1,1,1,1,1,1,1,1,1,3,3,3,2,
2,5,5,5,1,1,1,1,1,1,1,1,1,1,1,3,3,3,2,
2,1,1,1,1,1,1,1,1,1,1,1,1,1,1,1,1,1,2,
2,1,1,1,1,1,1,1,1,1,1,1,2,1,1,1,1,1,2,
2,1,1,1,1,1,2,1,1,1,1,1,1,1,1,1,1,1,2,
2,1,1,1,1,1,1,1,1,1,1,1,1,1,1,1,1,1,2,
2,1,1,1,3,3,3,3,3,3,3,3,3,3,3,1,1,1,2,
2,2,2,2,2,2,2,2,2,2,2,2,2,2,2,2,2,2,2
POSITION
SHADOWHUNTER 90 32
SHIELDMAIDEN 500 500 1
TALISMANIAC 12 90
LIGHTBRINGER 14 23
HANDLE 900 300
DUMMY 950 600
ENDOFFILE