LEVEL_INFORMATION
Tutorial_Beginning
TILES
2,2,2,2,2,2,2,2,2,2,2,2,2,2,2,2,2,2,2,
2,1,1,1,1,1,1,1,1,1,1,2,1,2,1,2,1,1,2,
2,1,1,1,1,1,1,1,1,1,1,2,1,2,1,2,1,1,2,
2,2,2,2,2,2,2,2,2,1,1,2,1,1,1,2,1,1,2,
2,1,1,1,1,1,1,1,2,1,1,2,1,2,1,2,1,1,2,
2,1,2,2,2,1,2,1,1,1,2,1,1,2,1,2,1,1,2,
2,1,1,1,1,1,2,1,1,1,2,1,1,2,1,2,1,1,2,
2,2,2,2,1,2,2,2,2,2,2,2,1,2,1,2,1,1,2,
2,1,1,1,1,1,1,1,1,1,1,1,1,2,1,1,1,1,2,
2,2,2,2,2,2,2,2,2,2,2,2,2,2,2,2,2,2,2
POSITION
SHIELDMAIDEN 300 300 1
SHIELDMAIDEN 200 300 2
DUMMY 900 600
BUNNY 1600 100
BUNNY 100 200
ENDOFFILE

note: this is not the actual tutorial level, more like a test level