LEVEL_INFORMATION
sewers, wut?
TILES
2,2,2,2,2,2,2,2,2,2,2,2,2,2,2,2,2,2,2,2,2,2,2,2,2,2,2,2,2,2,2,2,2,2,2,2,2,2,
2,1,1,1,5,5,1,1,1,1,1,1,1,2,1,1,1,1,1,1,1,1,2,1,1,1,2,1,1,1,5,5,5,5,1,1,1,2,
2,1,1,1,5,5,1,1,1,1,1,1,1,2,1,1,1,1,1,1,1,1,2,1,1,1,2,1,1,1,5,5,5,5,1,1,1,2,
2,1,1,1,5,5,1,1,1,1,2,1,1,2,1,1,2,2,2,2,2,2,2,1,1,1,2,1,1,2,5,5,5,5,1,1,1,2,
2,1,1,1,5,5,2,2,2,2,2,1,1,1,1,1,1,1,1,1,1,1,1,1,1,1,1,1,1,1,7,2,2,7,1,1,1,2,
2,1,1,2,5,5,1,1,1,1,2,1,1,1,1,1,1,1,1,1,1,1,1,1,1,1,1,1,1,1,6,6,6,6,1,1,1,2,
2,1,1,1,5,5,1,1,1,1,2,1,1,2,1,1,1,1,1,1,1,1,1,1,1,1,1,1,1,1,6,6,6,6,1,1,1,2,
2,1,1,1,5,5,2,1,1,2,2,1,1,2,1,1,2,2,2,2,2,2,2,1,1,1,1,1,1,1,7,2,2,7,2,2,2,2,
2,1,1,1,6,6,1,1,1,1,2,1,1,2,1,1,1,1,1,2,1,1,2,1,1,2,1,1,2,2,5,5,5,5,1,1,1,2,
2,1,1,1,6,6,1,1,1,1,2,1,1,2,1,1,1,1,1,2,1,1,2,1,1,2,1,1,1,1,5,5,5,5,1,1,1,2,
2,1,1,1,5,5,1,1,1,1,2,1,1,2,2,2,2,2,2,2,1,1,2,2,2,2,1,1,1,1,5,5,5,5,1,1,1,2,
2,1,1,1,5,5,1,1,1,1,1,1,1,1,1,1,1,1,1,1,1,1,1,1,2,1,1,1,1,1,5,5,5,5,2,1,1,2,
2,1,1,1,5,5,1,1,1,1,1,1,1,1,1,1,1,1,1,1,1,1,1,1,2,1,1,1,1,1,5,5,5,5,2,1,1,2,
2,1,1,1,5,5,1,1,1,1,1,1,1,1,1,1,1,1,2,1,1,1,1,1,2,1,1,1,1,1,5,5,5,5,1,1,1,2,
2,6,6,7,5,5,5,5,5,5,5,5,5,7,7,5,5,5,5,5,5,5,5,5,5,7,6,6,7,5,5,5,5,5,1,1,1,2,
2,6,6,2,5,5,5,5,5,5,5,5,5,7,7,5,5,5,5,5,5,5,5,5,5,2,6,6,2,5,5,5,5,5,2,1,1,2,
2,6,6,2,5,5,5,5,5,5,5,5,5,7,7,5,5,5,5,5,5,5,5,5,5,2,6,6,2,5,5,5,5,5,2,1,1,2,
2,6,6,7,5,5,5,5,5,5,5,5,5,7,7,5,5,5,5,5,5,5,5,5,5,7,6,6,7,5,5,5,5,5,1,1,1,2,
2,1,1,1,1,1,1,1,1,1,5,5,1,1,1,1,1,1,1,1,1,1,1,2,1,1,1,1,1,1,1,1,1,1,1,1,1,2,
2,1,1,1,1,1,1,1,1,1,5,5,1,1,1,1,1,1,1,1,1,1,1,2,1,1,1,1,1,1,1,1,1,1,1,1,1,2,
2,2,2,2,2,2,2,2,2,2,2,2,2,2,2,2,2,2,2,2,2,2,2,2,2,2,2,2,2,2,2,2,2,2,2,2,2,2
POSITION
SHIELDMAIDEN 100 80 1
SHIELDMAIDEN 150 80 2
SHIELDMAIDEN 1400 80 3
SHIELDMAIDEN 1450 80 4
ENDOFFILE

note: this is not the actual tutorial level, more like a test level