LEVEL_INFORMATION
No pain, no gain - jailbreak
TILES
2,2,2,2,2,2,2,2,2,2,2,2,2,2,2,2,2,2,2,2,2,2,2,2,2,2,2,2,2,2,2,2,2,2,2,2,2,2,
2,1,1,1,1,1,1,1,1,2,1,1,1,1,1,2,1,1,1,1,2,1,1,1,1,1,1,1,1,2,1,1,1,1,1,1,1,2,
2,1,1,1,1,1,1,1,1,2,1,1,1,1,1,2,1,1,1,1,1,1,1,1,1,1,1,1,1,2,1,1,1,1,1,1,1,2,
2,1,1,2,1,1,1,1,1,2,1,1,1,1,1,2,1,1,1,1,1,1,1,1,1,2,2,1,1,2,1,1,1,1,2,1,1,2,
2,1,1,2,1,1,1,1,1,2,1,1,1,1,1,2,1,1,1,1,2,1,1,1,1,1,2,2,2,2,1,1,1,1,2,1,1,2,
2,2,2,2,2,2,2,2,2,2,1,1,1,1,1,2,2,2,2,2,2,1,1,1,1,1,2,1,1,1,1,1,1,1,2,1,1,2,
2,1,1,2,1,1,1,1,1,2,1,1,1,1,1,2,1,1,1,1,2,1,1,1,1,1,2,1,1,1,1,1,1,1,2,1,1,2,
2,1,1,1,1,1,1,1,1,2,1,1,1,1,1,2,1,1,1,1,1,1,1,1,1,2,2,1,1,2,2,2,2,2,2,1,1,2,
2,1,1,1,1,1,1,1,1,2,1,1,1,1,1,2,1,1,1,1,1,1,1,1,1,1,1,1,1,2,1,1,1,1,1,1,1,2,
2,1,1,2,1,1,1,1,1,2,1,1,1,1,1,2,1,1,1,1,2,1,1,1,1,1,1,1,1,2,1,1,1,1,1,1,1,2,
2,2,2,2,2,2,2,2,2,2,2,2,2,2,2,2,2,2,2,2,2,1,1,1,1,2,2,2,2,2,1,1,1,1,2,2,2,2,
2,1,1,2,1,1,1,1,1,2,1,1,1,1,1,2,1,1,1,1,2,1,1,1,1,1,1,1,1,2,1,1,1,1,1,1,1,2,
2,1,1,1,1,1,1,1,1,2,1,1,1,1,1,2,1,1,1,1,1,1,1,1,1,1,1,1,1,2,1,1,1,1,1,1,1,2,
2,1,1,1,1,1,1,1,1,2,1,1,1,1,1,2,1,1,1,1,1,1,1,1,1,2,2,1,1,2,2,2,2,2,2,1,1,2,
2,1,1,2,1,1,1,1,1,2,1,1,1,1,1,2,1,1,1,1,2,1,1,1,1,1,2,1,1,1,1,1,1,1,2,1,1,2,
2,2,2,2,2,2,2,2,2,2,1,1,1,1,1,2,2,2,2,2,2,1,1,1,1,1,2,1,1,1,1,1,1,1,2,1,1,2,
2,1,1,2,1,1,1,1,1,2,1,1,1,1,1,2,1,1,1,1,2,1,1,1,1,1,2,2,2,2,1,1,1,1,2,1,1,2,
2,1,1,2,1,1,1,1,1,2,1,1,1,1,1,2,1,1,1,1,1,1,1,1,1,2,2,1,1,2,1,1,1,1,2,1,1,2,
2,1,1,1,1,1,1,1,1,2,1,1,1,1,1,2,1,1,1,1,1,1,1,1,1,1,1,1,1,2,1,1,1,1,1,1,1,2,
2,1,1,1,1,1,1,1,1,2,1,1,1,1,1,2,1,1,1,1,2,1,1,1,1,1,1,1,1,2,1,1,1,1,1,1,1,2,
2,2,2,2,2,2,2,2,2,2,2,2,2,2,2,2,2,2,2,2,2,2,2,2,2,2,2,2,2,2,2,2,2,2,2,2,2,2
POSITION
SHIELDMAIDEN 100 150 1
SHIELDMAIDEN 100 400 2
SHIELDMAIDEN 100 650 3
SHIELDMAIDEN 100 900 4
BUNNY 300 350
BUNNY 300 600
BUNNY 900 150
BUNNY 900 400
BUNNY 900 650
BUNNY 900 900
BUNNY 1650 50
BUNNY 1650 100
BUNNY 1650 900
BUNNY 1650 950
BUNNY 1150 200
BUNNY 1150 400
BUNNY 1150 600
BUNNY 1150 800
SPIKETRAP 200 50
SPIKETRAP 300 50
SPIKETRAP 200 150
SPIKETRAP 200 800
SPIKETRAP 200 900
SPIKETRAP 300 900
SPIKETRAP 500 100
SPIKETRAP 600 100
SPIKETRAP 550 200
SPIKETRAP 650 200
SPIKETRAP 550 300
SPIKETRAP 650 300
SPIKETRAP 600 400
SPIKETRAP 600 550
SPIKETRAP 550 650
SPIKETRAP 650 650
SPIKETRAP 550 750
SPIKETRAP 650 750
SPIKETRAP 500 850
SPIKETRAP 600 850
PENGUIN 1800 400
PENGUIN 1800 600
VDOOR 450 50 1
VDOOR 150 300 2
VDOOR 450 300 2
VDOOR 150 550 3
VDOOR 450 550 3
VDOOR 450 800 4
VDOOR 750 50 5
VDOOR 750 300 6
VDOOR 750 550 7
VDOOR 750 800 8
VDOOR 1250 0 9
VDOOR 1250 350 10
VDOOR 1250 500 11
VDOOR 1250 850 12
VDOOR 1450 200 13
VDOOR 1450 650 14
VDOOR 1650 350 15
VDOOR 1650 500 15
TRAPDOOR 1505 350 17
HANDLE 360 170 2
HANDLE 360 760 3
HANDLE 860 300 5
HANDLE 860 550 8
HANDLE 1760 250 15
HANDLE 1510 500 99
HANDLE 1360 100 10
HANDLE 1360 850 11
LOCK 458 124 BLUE 2
LOCK 458 874 GREEN 3
LOCK 730 374 RED 1
LOCK 730 624 ORANGE 4
LOCK 1230 74 BLUE 2
LOCK 1230 924 GREEN 3
LOCK 1430 274 ALL 5
LOCK 1430 724 ALL 5
KEY 100 300 BLUE 2
KEY 100 550 GREEN 3
KEY 300 200 RED 1
KEY 300 800 ORANGE 4
KEY 950 50 BLUE 2
KEY 950 800 GREEN 3
KEY 1400 50 ALL 5
KEY 1400 950 ALL 5
ENDOFFILE

note: this is not the actual tutorial level, more like a test level